t_start,t_end,duration_s,alt_gain_m,climb_rate_ms,lat,lon,cluster_id
12667,12687,20,38,1.9,-32.25081333333333,116.98628,0
12878,12923,45,79,1.7555555555555555,-32.23526666666667,116.98125,1
12928,12978,50,90,1.8,-32.236998484848485,116.9808484848485,2
12993,13018,25,47,1.88,-32.23934166666667,116.98027222222224,3
13033,13078,45,48,1.0666666666666667,-32.242336666666674,116.98024500000001,4
13693,13748,55,139,2.5272727272727273,-32.13550277777778,116.93869305555553,5
13803,13853,50,90,1.8,-32.13401515151514,116.94009696969698,6
13888,13913,25,38,1.52,-32.134655555555554,116.94263055555557,7
14068,14088,20,30,1.5,-32.14022666666667,116.94107,8
14118,14138,20,37,1.85,-32.142880000000005,116.94139333333332,9
14283,14308,25,49,1.96,-32.152319444444444,116.94561388888889,10
14338,14363,25,37,1.48,-32.15513333333333,116.94625277777777,11
14635,14662,27,74,2.740740740740741,-32.118605555555554,116.94793703703706,12
14704,14744,40,87,2.175,-32.1086962962963,116.94548888888887,13
14844,14884,40,111,2.775,-32.10783518518518,116.94216481481482,14
14914,14934,20,49,2.45,-32.11027666666667,116.94370333333333,15
14954,14974,20,50,2.5,-32.112543333333335,116.94555333333332,16
15029,15053,24,38,1.5833333333333333,-32.11688518518518,116.94816296296297,17
15557,15582,25,68,2.72,-32.29038055555555,117.04110555555555,18
15727,15852,125,328,2.624,-32.34893974358974,117.07455000000002,19
16037,16163,126,520,4.126984126984127,-32.404816025641026,117.10471666666665,20
16208,16403,195,618,3.169230769230769,-32.41178541666667,117.10599208333333,21
16408,16433,25,97,3.88,-32.41295,117.10966388888887,22
16498,16523,25,42,1.68,-32.44295833333333,117.12849722222222,23
17178,17198,20,91,4.55,-32.72871666666667,117.30093333333335,24
17203,17603,400,1502,3.755,-32.74717448559671,117.30984053497941,25
17979,18164,185,564,3.0486486486486486,-32.946331578947365,117.42459999999997,26
18744,18939,195,928,4.758974358974359,-33.247929166666665,117.53819041666668,27
18944,18984,40,177,4.425,-33.25453703703704,117.54196851851852,28
18989,19054,65,227,3.4923076923076923,-33.25754047619048,117.54424404761905,29
19339,19365,26,204,7.846153846153846,-33.387274999999995,117.64421111111112,30
19370,19525,155,733,4.7290322580645165,-33.39094166666666,117.64935,31
20070,20185,115,350,3.0434782608695654,-33.66626875,117.81973402777778,32
20195,20300,105,493,4.695238095238095,-33.68359545454545,117.82557121212125,33
20550,20585,35,153,4.371428571428571,-33.80816458333333,117.91085416666667,34
21045,21141,96,318,3.3125,-34.02588416666667,118.04467,35
21291,21476,185,672,3.6324324324324326,-34.1008793859649,118.08684736842105,36
21601,21636,35,137,3.914285714285714,-34.060043750000006,118.07713125000001,37
21641,21661,20,40,2.0,-34.060073333333335,118.0787,38
21791,21811,20,49,2.45,-34.01284,118.04801,39
22281,22301,20,41,2.05,-33.84274666666666,117.92429666666666,40
22426,22476,50,152,3.04,-33.81566212121212,117.8834984848485,41
22661,23037,376,1575,4.1888297872340425,-33.78379714912281,117.83209078947368,42
23042,23067,25,62,2.48,-33.79316388888889,117.84662777777778,43
23097,23117,20,131,6.55,-33.784620000000004,117.83916666666667,44
23452,23522,70,322,4.6,-33.66068444444444,117.75502555555555,45
23527,23552,25,79,3.16,-33.66262777777778,117.75782777777776,46
23582,23702,120,414,3.45,-33.653866666666666,117.74561066666666,47
23722,23752,30,166,5.533333333333333,-33.64604047619047,117.73879047619047,48
23852,23872,20,170,8.5,-33.60368999999999,117.71726000000001,49
23882,23937,55,205,3.727272727272727,-33.60267638888889,117.71992083333333,50
23972,23992,20,70,3.5,-33.58484,117.70711000000001,51
24037,24062,25,161,6.44,-33.561027777777774,117.69501388888888,52
24287,24322,35,113,3.2285714285714286,-33.47087916666666,117.64400208333335,53
24417,24442,25,179,7.16,-33.42720833333333,117.61676388888888,54
24447,24698,251,769,3.0637450199203187,-33.432835294117645,117.6228562091503,55
24938,24963,25,78,3.12,-33.34838333333333,117.57446944444445,56
25048,25068,20,158,7.9,-33.308746666666664,117.55566666666667,57
25073,25118,45,97,2.1555555555555554,-33.310446666666664,117.55648000000001,58
25233,25253,20,108,5.4,-33.263079999999995,117.52882333333332,59
25488,25673,185,589,3.1837837837837837,-33.16879692982455,117.47817894736842,60
25788,25808,20,47,2.35,-33.12958333333333,117.45486666666666,61
25878,25908,30,141,4.7,-33.09511904761904,117.43441666666665,62
25958,25978,20,79,3.95,-33.09403999999999,117.43360333333335,63
25983,26013,30,59,1.9666666666666666,-33.09310476190476,117.43434523809523,64
26378,26418,40,159,3.975,-32.958983333333336,117.3591648148148,65
26568,26899,331,997,3.012084592145015,-32.908649999999994,117.32683009950249,66
27504,27769,265,904,3.4113207547169813,-32.68672932098765,117.22383641975308,67
27774,27959,185,515,2.7837837837837838,-32.69060964912281,117.23663245614037,68
28284,28304,20,89,4.45,-32.56995333333333,117.15162333333333,69
28485,28555,70,269,3.842857142857143,-32.49142444444445,117.1106811111111,70
28560,28590,30,88,2.933333333333333,-32.4927261904762,117.11191666666666,71
28600,28630,30,77,2.566666666666667,-32.49466904761905,117.11328333333333,72
28640,28755,115,261,2.2695652173913046,-32.49967847222222,117.11781805555556,73
28760,28780,20,41,2.05,-32.501780000000004,117.12145000000001,74
28785,28820,35,40,1.1428571428571428,-32.503425,117.12317916666666,75
29045,29100,55,160,2.909090909090909,-32.40175,117.13909583333333,76
29465,29490,25,122,4.88,-32.24814722222222,117.20013055555557,77
29495,29520,25,44,1.76,-32.24863888888889,117.20025833333334,78
29686,29711,25,119,4.76,-32.182119444444446,117.23829166666667,79
29766,29791,25,65,2.6,-32.17655,117.2172388888889,80
29876,29976,100,319,3.19,-32.155788888888885,117.17752063492063,81
29981,30382,401,1155,2.880299251870324,-32.15846275720165,117.17804465020576,82
30968,30988,20,94,4.7,-32.20573,117.34666000000001,83
30993,31018,25,53,2.12,-32.20671111111111,117.3474111111111,84
31028,31063,35,57,1.6285714285714286,-32.20724791666666,117.35016250000001,85
31068,31098,30,43,1.4333333333333333,-32.20743571428572,117.35014523809524,86
31103,31123,20,39,1.95,-32.209086666666664,117.35042666666666,87
31374,31394,20,33,1.65,-32.19108333333334,117.25263333333332,88
31434,31464,30,44,1.4666666666666666,-32.1933880952381,117.25526428571429,89
31834,31854,20,33,1.65,-32.108736666666665,117.1606,90
32039,32059,20,42,2.1,-32.06537333333333,117.08966666666667,91
32064,32089,25,78,3.12,-32.063880555555556,117.08137777777777,92
32094,32134,40,59,1.475,-32.065237037037036,117.08123518518521,93
32139,32170,31,49,1.5806451612903225,-32.0665,117.08124047619049,94
32500,32595,95,155,1.631578947368421,-32.05187,117.00333083333332,95
32600,32625,25,51,2.04,-32.05271944444444,117.00493611111112,96
32630,32785,155,338,2.1806451612903226,-32.05485208333334,117.0064625,97
32790,32835,45,67,1.488888888888889,-32.05722333333333,117.00920666666669,98
32850,32920,70,87,1.2428571428571429,-32.058910000000004,117.01045555555557,99
32925,33115,190,473,2.4894736842105263,-32.06221965811966,117.01155811965812,100
33120,33140,20,52,2.6,-32.064326666666666,117.01346000000001,101
33145,33205,60,124,2.066666666666667,-32.06512179487179,117.01401025641024,102
33215,33275,60,134,2.2333333333333334,-32.06466666666666,117.01200897435896,103
33280,33305,25,66,2.64,-32.064997222222225,117.01207222222223,104
33310,33365,55,127,2.309090909090909,-32.06609027777778,117.01371944444442,105
33370,33390,20,51,2.55,-32.066873333333334,117.01467333333332,106
33410,33440,30,57,1.9,-32.068397619047616,117.01530238095238,107
33475,33495,20,36,1.8,-32.06911666666666,117.01683666666668,108
33500,33640,140,226,1.6142857142857143,-32.071250000000006,117.0174724137931,109
33650,33705,55,89,1.6181818181818182,-32.074127777777775,117.01948750000003,110
33825,33855,30,49,1.6333333333333333,-32.07618333333333,117.0231880952381,111
34326,34346,20,50,2.5,-31.969330000000003,116.98528666666667,112
34506,34526,20,61,3.05,-31.91174666666667,116.96833666666666,113
34691,34726,35,98,2.8,-31.86458125,116.95527708333333,114
35596,35616,20,97,4.85,-31.92116666666667,116.95103999999999,115
35621,35911,290,565,1.9482758620689655,-31.925759039548023,116.95212344632769,116
35916,35946,30,39,1.3,-31.928180952380952,116.95483333333333,117
35951,35987,36,45,1.25,-31.928316666666667,116.954575,118
36037,36127,90,235,2.611111111111111,-31.940086842105266,116.95605350877194,119
36132,36187,55,111,2.018181818181818,-31.942770833333338,116.95431527777777,120
36192,36242,50,77,1.54,-31.944172727272726,116.9522818181818,121
37062,37082,20,43,2.15,-32.22863333333333,117.03418000000002,122
37092,37112,20,39,1.95,-32.23655,117.04148333333335,123
37212,37282,70,154,2.2,-32.26860222222223,117.07265888888888,124
37287,37312,25,42,1.68,-32.26876388888889,117.07505555555555,125
37317,37337,20,42,2.1,-32.26900333333333,117.07484333333332,126
37342,37367,25,54,2.16,-32.268708333333336,117.07564166666668,127
38278,38298,20,106,5.3,-32.12222333333333,116.9496,128
