t_start,t_end,duration_s,alt_gain_m,climb_rate_ms,lat,lon,cluster_id
9415,9591,176,510,2.897727272727273,-32.1207688888889,116.95721999999999,0
9595,9791,196,494,2.520408163265306,-32.13735233333333,116.96243666666665,1
9795,9831,36,61,1.6944444444444444,-32.13879666666667,116.96121833333333,2
9835,9855,20,33,1.65,-32.13917222222222,116.96140555555554,3
9875,9903,28,47,1.6785714285714286,-32.13630625,116.95772916666667,4
9963,10103,140,376,2.6857142857142855,-32.11579120370371,116.9454726851852,5
10383,10631,248,780,3.1451612903225805,-32.0223671957672,116.93864867724865,6
10699,10731,32,65,2.03125,-32.00106851851852,116.9270037037037,7
11103,11123,20,62,3.1,-31.855791666666665,116.91049444444445,8
11131,11151,20,56,2.8,-31.854836111111116,116.91034722222223,9
11171,11239,68,182,2.676470588235294,-31.85363425925926,116.90837592592591,10
11663,11731,68,100,1.4705882352941178,-31.747409259259257,116.91346666666666,11
11771,11803,32,40,1.25,-31.747714814814813,116.91126296296297,12
11935,11959,24,78,3.25,-31.7037,116.91584999999999,13
11963,12123,160,409,2.55625,-31.703792276422767,116.91077235772357,14
12127,12231,104,318,3.0576923076923075,-31.705054320987657,116.90417716049382,15
12247,12295,48,87,1.8125,-31.707744871794873,116.89918846153844,16
12331,12487,156,519,3.326923076923077,-31.700245416666668,116.89459833333333,17
12727,12751,24,67,2.7916666666666665,-31.608890476190474,116.86421666666665,18
12891,12911,20,46,2.3,-31.567533333333333,116.86354999999999,19
13107,13135,28,42,1.5,-31.502125,116.86814791666667,20
13167,13187,20,51,2.55,-31.495555555555555,116.86818611111111,21
13275,13323,48,89,1.8541666666666667,-31.4911358974359,116.86253076923079,22
13363,13435,72,122,1.6944444444444444,-31.492500000000003,116.8587552631579,23
13623,13659,36,96,2.6666666666666665,-31.429025000000003,116.84307833333332,24
13723,13743,20,42,2.1,-31.429475,116.83919722222224,25
13767,13787,20,49,2.45,-31.429375000000004,116.83748611111112,26
13815,13951,136,315,2.3161764705882355,-31.42832238095238,116.83456476190476,27
14227,14287,60,140,2.3333333333333335,-31.356885416666668,116.85461145833334,28
14467,14635,168,618,3.6785714285714284,-31.30875387596899,116.84866201550392,29
14663,14683,20,55,2.75,-31.306894444444442,116.84646944444444,30
14951,14983,32,88,2.75,-31.20028148148148,116.83205925925927,31
15043,15147,104,267,2.5673076923076925,-31.19025802469136,116.83404074074075,32
15151,15187,36,105,2.9166666666666665,-31.189293333333335,116.83183000000001,33
15339,15375,36,102,2.8333333333333335,-31.139795,116.81561666666667,34
15691,15883,192,399,2.078125,-31.03806598639456,116.80304931972789,35
16151,16387,236,658,2.788135593220339,-30.96763777777778,116.79531083333333,36
16747,16771,24,47,1.9583333333333333,-30.830045238095238,116.79534523809524,37
16779,16855,76,264,3.473684210526316,-30.827977499999996,116.80173416666666,38
16867,17063,196,709,3.61734693877551,-30.824793333333336,116.800378,39
17067,17095,28,54,1.9285714285714286,-30.820629166666667,116.799625,40
17571,17679,108,331,3.064814814814815,-30.65440476190476,116.76990892857143,41
17683,17775,92,236,2.5652173913043477,-30.653992361111108,116.76659097222223,42
17779,17859,80,160,2.0,-30.65549682539683,116.76279603174605,43
18043,18071,28,122,4.357142857142857,-30.579920833333333,116.74376666666666,44
18075,18107,32,55,1.71875,-30.579762962962963,116.74520370370368,45
18115,18143,28,74,2.642857142857143,-30.578995833333334,116.74359583333333,46
18307,18507,200,649,3.245,-30.526387581699353,116.7315754901961,47
18647,18683,36,106,2.9444444444444446,-30.48549833333334,116.71911833333334,48
19111,19211,100,231,2.31,-30.330703205128202,116.6853141025641,49
19215,19239,24,56,2.3333333333333335,-30.32990952380953,116.68665476190475,50
19243,19279,36,78,2.1666666666666665,-30.33000333333333,116.68786666666668,51
19383,19411,28,85,3.0357142857142856,-30.285870833333334,116.68221458333333,52
19511,19535,24,48,2.0,-30.246502380952386,116.67025476190476,53
19727,19787,60,178,2.966666666666667,-30.163465625,116.65048958333334,54
19803,19831,28,44,1.5714285714285714,-30.16183125,116.65116041666667,55
19963,20143,180,549,3.05,-30.11251811594202,116.62606956521738,56
20147,20287,140,363,2.592857142857143,-30.111681481481483,116.62533101851851,57
20583,20603,20,64,3.2,-30.18213333333333,116.74524444444445,58
20639,20739,100,306,3.06,-30.175952564102566,116.76040128205128,59
20803,20967,164,612,3.731707317073171,-30.195263888888896,116.79484841269843,60
20971,20991,20,45,2.25,-30.195333333333334,116.7972361111111,61
21571,21595,24,32,1.3333333333333333,-30.3331119047619,117.02334761904761,62
21855,21947,92,199,2.1630434782608696,-30.386228472222218,117.08163541666666,63
21951,21975,24,36,1.5,-30.386042857142858,117.0815357142857,64
21991,22099,108,415,3.8425925925925926,-30.387807142857145,117.08684702380955,65
22103,22127,24,63,2.625,-30.38674047619048,117.08664047619048,66
22131,22151,20,44,2.2,-30.388166666666667,117.09042222222223,67
22595,22703,108,347,3.212962962962963,-30.495478571428567,117.26875238095238,68
22715,22791,76,214,2.8157894736842106,-30.49796916666667,117.26884999999997,69
22795,22827,32,61,1.90625,-30.499122222222223,117.26845,70
23039,23095,56,211,3.767857142857143,-30.55484444444444,117.34054444444448,71
23099,23139,40,81,2.025,-30.554528787878784,117.34105,72
23395,23451,56,219,3.9107142857142856,-30.62427888888889,117.41706111111112,73
23455,23535,80,205,2.5625,-30.625419841269842,117.41636507936508,74
23815,23843,28,75,2.6785714285714284,-30.68064791666667,117.48763541666668,75
23851,23891,40,69,1.725,-30.67972575757576,117.49017272727271,76
24071,24103,32,83,2.59375,-30.72747037037037,117.54400370370371,77
24115,24199,84,231,2.75,-30.727384090909087,117.54393484848487,78
24219,24251,32,81,2.53125,-30.72772777777778,117.5466351851852,79
24255,24351,96,218,2.2708333333333335,-30.728137999999998,117.54776533333332,80
24619,24639,20,71,3.55,-30.79245,117.6545,81
24855,24919,64,148,2.3125,-30.854692156862743,117.72218137254902,82
24971,25155,184,546,2.967391304347826,-30.859474822695038,117.72839078014182,83
25515,25539,24,50,2.0833333333333335,-30.94709047619048,117.85433095238098,84
25543,25563,20,41,2.05,-30.94609166666667,117.853925,85
25571,25615,44,99,2.25,-30.94378472222222,117.8541763888889,86
25635,25655,20,36,1.8,-30.943252777777776,117.85374444444444,87
25663,25799,136,376,2.764705882352941,-30.939095238095238,117.85247714285714,88
26063,26239,176,446,2.534090909090909,-31.008312962962965,117.9200303703704,89
26247,26267,20,49,2.45,-31.007622222222224,117.920125,90
26275,26331,56,107,1.9107142857142858,-31.007571111111112,117.92077444444446,91
26335,26367,32,59,1.84375,-31.007724074074076,117.92065185185184,92
26467,26711,244,821,3.3647540983606556,-31.035698924731182,117.96412795698923,93
26819,26891,72,212,2.9444444444444446,-31.067798245614032,118.00458245614037,94
27179,27363,184,479,2.6032608695652173,-31.145444326241137,118.10591737588653,95
27591,27623,32,85,2.65625,-31.191192592592593,118.2054648148148,96
27627,27695,68,188,2.764705882352941,-31.19151666666667,118.20673796296296,97
27699,27779,80,207,2.5875,-31.190708730158732,118.20718412698413,98
27819,27843,24,44,1.8333333333333333,-31.19929761904762,118.22757380952382,99
28035,28059,24,51,2.125,-31.260392857142858,118.30935952380953,100
28063,28103,40,83,2.075,-31.265460606060607,118.31205303030302,101
28107,28135,28,51,1.8214285714285714,-31.263114583333333,118.31181875,102
28443,28755,312,859,2.753205128205128,-31.332864767932485,118.41832974683541,103
28867,28899,32,135,4.21875,-31.35812037037037,118.45045740740741,104
28907,28963,56,128,2.2857142857142856,-31.358794444444438,118.4493188888889,105
29319,29355,36,63,1.75,-31.44267,118.38497833333334,106
29503,29543,40,84,2.1,-31.46506515151515,118.3316606060606,107
29571,29603,32,60,1.875,-31.470355555555557,118.32639074074073,108
29611,29639,28,48,1.7142857142857142,-31.467772916666668,118.32509999999999,109
29663,29683,20,34,1.7,-31.465683333333335,118.32705277777778,110
29847,29971,124,371,2.9919354838709675,-31.496734895833335,118.25956041666666,111
29975,30039,64,197,3.078125,-31.495774509803923,118.25959215686274,112
30091,30119,28,60,2.142857142857143,-31.496291666666668,118.26015833333334,113
30387,30475,88,278,3.159090909090909,-31.564985507246384,118.20217101449275,114
30483,30503,20,65,3.25,-31.565058333333337,118.20257222222222,115
30523,30571,48,92,1.9166666666666667,-31.565384615384616,118.20258846153845,116
30683,30727,44,122,2.772727272727273,-31.588399999999996,118.1613388888889,117
30771,30803,32,43,1.34375,-31.59227592592593,118.15703888888889,118
31023,31043,20,62,3.1,-31.635102777777774,118.06320555555556,119
31263,31291,28,86,3.0714285714285716,-31.668206249999997,117.98400000000001,120
31431,31779,348,843,2.4224137931034484,-31.674076136363635,117.95534488636363,121
32003,32039,36,77,2.138888888888889,-31.705243333333335,117.84262666666666,122
32043,32067,24,50,2.0833333333333335,-31.70603333333333,117.8378857142857,123
32071,32151,80,116,1.45,-31.70727380952381,117.83881507936506,124
32287,32307,20,33,1.65,-31.72200833333333,117.77722222222222,125
32315,32343,28,37,1.3214285714285714,-31.720875,117.76797708333334,126
32579,32611,32,97,3.03125,-31.75545185185185,117.68432037037039,127
32727,32795,68,136,2.0,-31.76403518518519,117.65260925925928,128
32799,32867,68,113,1.661764705882353,-31.764775925925928,117.65299814814814,129
32875,32907,32,67,2.09375,-31.76406481481482,117.65312592592593,130
33135,33155,20,68,3.4,-31.777361111111105,117.61242499999999,131
33219,33243,24,54,2.25,-31.77857619047619,117.60123095238096,132
33247,33271,24,30,1.25,-31.77902142857143,117.59902857142856,133
33303,33351,48,66,1.375,-31.77801538461538,117.59847564102564,134
33363,33387,24,36,1.5,-31.776966666666663,117.59714285714286,135
33535,33567,32,78,2.4375,-31.784857407407408,117.53981111111109,136
33571,33603,32,76,2.375,-31.78469074074074,117.5397314814815,137
33647,33703,56,94,1.6785714285714286,-31.78175,117.53962555555557,138
33771,33815,44,69,1.5681818181818181,-31.779947222222223,117.53937777777777,139
33819,33843,24,35,1.4583333333333333,-31.77877380952381,117.53987619047619,140
33855,33875,20,35,1.75,-31.778391666666668,117.54014722222222,141
34455,34479,24,38,1.5833333333333333,-31.888673809523812,117.37569761904763,142
34795,34947,152,334,2.1973684210526314,-31.93428675213676,117.30517564102567,143
34951,34971,20,37,1.85,-31.93269722222222,117.3035,144
34975,35139,164,338,2.0609756097560976,-31.9323503968254,117.30157857142856,145
35143,35171,28,55,1.9642857142857142,-31.93211458333333,117.30209375,146
35371,35399,28,41,1.4642857142857142,-31.96092708333333,117.25202083333333,147
