t_start,t_end,duration_s,alt_gain_m,climb_rate_ms,lat,lon,cluster_id
7676,7876,200,687,3.435,-32.10868170731707,116.94891178861789,0
7881,7971,90,209,2.3222222222222224,-32.09991403508772,116.9526359649123,1
7976,8026,50,115,2.3,-32.10825151515152,116.9532196969697,2
8161,8186,25,52,2.08,-32.14866111111111,116.95630277777776,3
8321,8381,60,62,1.0333333333333334,-32.17028974358974,116.9616435897436,4
8551,8611,60,104,1.7333333333333334,-32.205503846153846,116.97126025641025,5
8616,8661,45,62,1.3777777777777778,-32.21135333333334,116.97218166666667,6
8666,8686,20,44,2.2,-32.21431333333334,116.97231333333335,7
8701,8746,45,57,1.2666666666666666,-32.21897,116.97388666666669,8
8751,8781,30,31,1.0333333333333334,-32.223211904761904,116.9742,9
8786,8851,65,83,1.2769230769230768,-32.228680952380955,116.9752619047619,10
8881,8901,20,39,1.95,-32.24341666666667,116.97957000000001,11
9026,9056,30,47,1.5666666666666667,-32.288964285714286,116.97822857142857,12
9361,9401,40,119,2.975,-32.35943703703703,117.03854259259259,13
9406,9471,65,114,1.7538461538461538,-32.36349285714285,117.04363214285713,14
9526,9551,25,115,4.6,-32.36045,117.05765555555554,15
9556,9616,60,109,1.8166666666666667,-32.364828205128205,117.0611717948718,16
9621,9656,35,49,1.4,-32.37021875000001,117.06469583333333,17
9731,9771,40,73,1.825,-32.35273703703703,117.09290740740741,18
9906,9936,30,56,1.8666666666666667,-32.32996428571429,117.11444047619047,19
9941,9961,20,43,2.15,-32.32983,117.11581666666666,20
9971,10001,30,75,2.5,-32.33071904761905,117.11634285714285,21
10006,10076,70,131,1.8714285714285714,-32.335908888888895,117.11851555555555,22
10081,10136,55,108,1.9636363636363636,-32.3423875,117.12212916666665,23
10181,10206,25,34,1.36,-32.34397222222223,117.13006944444446,24
10286,10316,30,68,2.2666666666666666,-32.319607142857144,117.13460952380953,25
10341,10376,35,87,2.4857142857142858,-32.32134791666667,117.1386,26
10381,10521,140,316,2.257142857142857,-32.32954310344827,117.1432591954023,27
10806,10826,20,50,2.5,-32.24186999999999,117.21871666666667,28
10861,10881,20,72,3.6,-32.237026666666665,117.22574,29
11081,11106,25,39,1.56,-32.18206388888889,117.28305277777777,30
11306,11326,20,37,1.85,-32.13163333333334,117.33126333333334,31
11711,11741,30,64,2.1333333333333333,-32.09262857142857,117.37623095238095,32
11756,11786,30,70,2.3333333333333335,-32.09690952380953,117.37820476190477,33
11791,11861,70,211,3.0142857142857142,-32.101751111111106,117.38165555555555,34
11866,11936,70,139,1.9857142857142858,-32.108335555555556,117.38531222222223,35
11961,12021,60,92,1.5333333333333334,-32.11431282051282,117.3898294871795,36
12201,12221,20,76,3.8,-32.06344,117.41579666666667,37
12306,12341,35,173,4.942857142857143,-32.034549999999996,117.43593125000001,38
12346,12491,145,437,3.013793103448276,-32.04208444444444,117.44003222222224,39
12516,12671,155,511,3.296774193548387,-32.05665104166667,117.44856458333334,40
12826,12856,30,50,1.6666666666666667,-32.01329047619048,117.48421190476189,41
12866,12886,20,56,2.8,-32.013533333333335,117.48564666666667,42
13076,13096,20,37,1.85,-31.96261,117.54594666666667,43
13246,13326,80,245,3.0625,-31.919052941176467,117.58533725490196,44
13331,13381,50,123,2.46,-31.92402575757576,117.58831363636364,45
13386,13406,20,51,2.55,-31.926873333333333,117.59006,46
13456,13481,25,60,2.4,-31.931469444444446,117.59441666666669,47
13566,13591,25,83,3.32,-31.912652777777776,117.6137,48
13596,13686,90,220,2.4444444444444446,-31.91365701754386,117.6166157894737,49
13691,13726,35,110,3.142857142857143,-31.916460416666666,117.61870416666667,50
13731,13976,245,783,3.195918367346939,-31.923529000000002,117.62323966666669,51
14101,14326,225,725,3.2222222222222223,-31.888094565217393,117.6669804347826,52
14331,14351,20,61,3.05,-31.895793333333337,117.67495,53
14566,14586,20,92,4.6,-31.846043333333334,117.77433333333333,54
14646,14696,50,182,3.64,-31.819116666666662,117.79591212121213,55
14701,14801,100,262,2.62,-31.821333333333335,117.80119206349207,56
14806,14831,25,90,3.6,-31.82561111111111,117.80486944444444,57
14876,14901,25,62,2.48,-31.824322222222225,117.80414444444445,58
15146,15176,30,97,3.2333333333333334,-31.75205,117.9009619047619,59
15371,15441,70,322,4.6,-31.699832222222224,118.0025188888889,60
15446,15471,25,98,3.92,-31.70082777777778,118.00500277777779,61
15476,15506,30,113,3.7666666666666666,-31.703269047619045,118.0058976190476,62
15511,15566,55,181,3.290909090909091,-31.705575,118.00772083333334,63
15571,15621,50,145,2.9,-31.707784848484845,118.00936060606062,64
15921,15941,20,83,4.15,-31.640206666666664,118.13587666666668,65
15946,15966,20,92,4.6,-31.640496666666667,118.13860666666667,66
15981,16126,145,440,3.0344827586206895,-31.647277222222222,118.14090888888889,67
16151,16316,165,578,3.503030303030303,-31.658930392156858,118.14222647058826,68
16456,16481,25,166,6.64,-31.622958333333333,118.21622777777777,69
16506,16536,30,111,3.7,-31.622383333333335,118.22700952380953,70
16566,16611,45,167,3.7111111111111112,-31.624608333333338,118.23724499999999,71
16796,16821,25,177,7.08,-31.57915833333333,118.30895,72
16831,16856,25,83,3.32,-31.576527777777773,118.31158888888888,73
16891,16941,50,163,3.26,-31.57272424242424,118.32402272727272,74
17146,17181,35,176,5.0285714285714285,-31.5309625,118.45297916666667,75
17186,17206,20,49,2.45,-31.530626666666667,118.45507666666666,76
17211,17231,20,49,2.45,-31.536099999999998,118.46158666666665,77
17411,17431,20,114,5.7,-31.49879333333333,118.57367666666669,78
17566,17591,25,131,5.24,-31.458619444444448,118.65599166666668,79
17621,17661,40,112,2.8,-31.4569,118.6668925925926,80
17791,18021,230,1024,4.452173913043478,-31.404776595744682,118.7295195035461,81
18031,18061,30,115,3.8333333333333335,-31.399633333333334,118.74074761904761,82
18136,18156,20,131,6.55,-31.38279,118.78266666666666,83
18181,18261,80,341,4.2625,-31.36885980392157,118.79469509803921,84
18266,18286,20,68,3.4,-31.370096666666665,118.79501666666665,85
18311,18331,20,84,4.2,-31.370269999999998,118.80214000000001,86
18901,18991,90,449,4.988888888888889,-31.265301754385963,119.12080701754387,87
18996,19036,40,191,4.775,-31.266924074074073,119.12099074074074,88
19041,19061,20,85,4.25,-31.267763333333335,119.12033000000001,89
19106,19126,20,49,2.45,-31.262490000000003,119.14376666666666,90
19286,19306,20,190,9.5,-31.23606,119.25614,91
19321,19416,95,328,3.4526315789473685,-31.231320000000004,119.27578500000001,92
19426,19451,25,108,4.32,-31.23036388888889,119.29011666666668,93
19456,19481,25,69,2.76,-31.23205,119.29295,94
19811,19831,20,192,9.6,-31.153713333333332,119.27855333333335,95
19836,19941,105,445,4.238095238095238,-31.15399924242424,119.27869924242424,96
19946,19971,25,96,3.84,-31.15607777777778,119.279275,97
19991,20031,40,122,3.05,-31.142640740740735,119.26476851851852,98
20331,20366,35,150,4.285714285714286,-31.03734166666667,119.10411666666667,99
20406,20431,25,86,3.44,-31.019238888888893,119.09987777777779,100
20436,20461,25,63,2.52,-31.016841666666664,119.099125,101
20531,20586,55,175,3.1818181818181817,-31.00587361111111,119.08637777777777,102
20591,20631,40,125,3.125,-31.00701851851852,119.08792962962964,103
20851,20871,20,92,4.6,-30.93892333333334,118.98154,104
20996,21016,20,52,2.6,-30.905103333333336,118.90606000000002,105
21046,21071,25,71,2.84,-30.897472222222223,118.89096666666667,106
21086,21151,65,254,3.9076923076923076,-30.889355952380953,118.87908095238097,107
21156,21296,140,440,3.142857142857143,-30.888898850574712,118.87760747126437,108
21321,21341,20,88,4.4,-30.884616666666666,118.87164,109
21346,21396,50,185,3.7,-30.884859090909085,118.87330909090907,110
21421,21441,20,136,6.8,-30.877136666666665,118.86052666666667,111
21446,21466,20,69,3.45,-30.876839999999998,118.85707,112
21646,21671,25,148,5.92,-30.807775000000003,118.79551666666669,113
21806,21846,40,168,4.2,-30.765401851851852,118.7993925925926,114
21851,21926,75,248,3.3066666666666666,-30.767547916666665,118.80130729166666,115
21966,21996,30,145,4.833333333333333,-30.745050000000003,118.79461666666666,116
22171,22196,25,123,4.92,-30.665341666666663,118.74416666666666,117
22216,22241,25,200,8.0,-30.64707777777778,118.73569722222221,118
22251,22291,40,121,3.025,-30.63618333333333,118.7278962962963,119
22676,22701,25,136,5.44,-30.52299722222222,118.54063055555555,120
22716,22766,50,155,3.1,-30.51354848484848,118.53329696969699,121
22771,22806,35,97,2.7714285714285714,-30.515745833333334,118.53053541666667,122
22861,22881,20,104,5.2,-30.504943333333337,118.50543666666665,123
22906,22926,20,178,8.9,-30.48879,118.50448666666666,124
22931,22951,20,58,2.9,-30.48662,118.50324,125
23106,23126,20,117,5.85,-30.436653333333332,118.46273999999998,126
23236,23256,20,120,6.0,-30.406146666666665,118.40844999999999,127
23281,23336,55,149,2.709090909090909,-30.40491527777778,118.39732361111112,128
23411,23521,110,399,3.6272727272727274,-30.385190579710144,118.34633260869566,129
23546,23566,20,61,3.05,-30.382863333333336,118.34321,130
23656,23686,30,118,3.933333333333333,-30.33598333333333,118.32000000000001,131
23701,23721,20,67,3.35,-30.322443333333332,118.31415666666666,132
23931,23971,40,188,4.7,-30.205144444444443,118.26970185185185,133
23976,24086,110,497,4.5181818181818185,-30.19995797101449,118.26633550724638,134
24116,24156,40,122,3.05,-30.17866666666667,118.2513574074074,135
24291,24321,30,142,4.733333333333333,-30.158271428571428,118.16633333333334,136
24456,24481,25,112,4.48,-30.10717777777778,118.09919444444445,137
24661,24771,110,369,3.3545454545454545,-30.06039347826087,118.0024304347826,138
24806,24826,20,85,4.25,-30.050583333333332,117.97556666666667,139
24956,24986,30,146,4.866666666666666,-30.00425238095238,117.90045952380954,140
25071,25091,20,136,6.8,-29.999466666666667,117.83751333333332,141
25291,25321,30,150,5.0,-29.954569047619053,117.73075238095238,142
25371,25396,25,61,2.44,-29.946766666666665,117.7061861111111,143
25446,25471,25,142,5.68,-29.933158333333335,117.67485555555555,144
25821,25841,20,84,4.2,-29.874436666666668,117.4903,145
25866,25886,20,51,2.55,-29.877933333333335,117.46677,146
25976,26046,70,239,3.414285714285714,-29.873748888888887,117.40361222222224,147
26051,26076,25,53,2.12,-29.873408333333334,117.40352499999999,148
26096,26136,40,75,1.875,-29.872946296296295,117.40313703703704,149
26201,26221,20,54,2.7,-29.875400000000003,117.3971,150
26226,26246,20,43,2.15,-29.876326666666664,117.39913333333334,151
26341,26381,40,147,3.675,-29.875905555555555,117.36147037037037,152
26396,26416,20,82,4.1,-29.87747,117.35355333333332,153
26461,26481,20,51,2.55,-29.88193,117.32075999999999,154
26516,26541,25,176,7.04,-29.88348611111111,117.29085555555555,155
26566,26596,30,80,2.6666666666666665,-29.88443571428571,117.28816666666667,156
26646,26686,40,132,3.3,-29.885501851851853,117.28844814814813,157
26691,26721,30,103,3.433333333333333,-29.886619047619043,117.28865952380953,158
26856,26876,20,70,3.5,-29.874469999999995,117.22267000000002,159
26886,26921,35,89,2.5428571428571427,-29.874652083333334,117.22022083333334,160
26926,26971,45,134,2.977777777777778,-29.87565166666667,117.21869666666666,161
27016,27166,150,492,3.28,-29.870058602150532,117.18923440860216,162
27171,27251,80,272,3.4,-29.86907450980392,117.19001960784313,163
27366,27386,20,113,5.65,-29.859893333333332,117.11756,164
27401,27436,35,267,7.628571428571429,-29.85776875,117.09668124999999,165
27476,27501,25,97,3.88,-29.85858055555555,117.06205555555556,166
27531,27551,20,84,4.2,-29.85473,117.04082333333331,167
27571,27596,25,145,5.8,-29.8468,117.02513611111111,168
27651,27671,20,37,1.85,-29.842263333333335,116.98320666666666,169
27691,27711,20,161,8.05,-29.84645333333333,116.96173999999999,170
27991,28011,20,42,2.1,-29.77216333333333,116.81352999999999,171
28221,28261,40,154,3.85,-29.706661111111114,116.70822407407407,172
28316,28341,25,47,1.88,-29.684186111111114,116.67900277777778,173
28436,28471,35,152,4.3428571428571425,-29.64659791666667,116.62549791666666,174
28496,28556,60,143,2.3833333333333333,-29.643200000000004,116.62260128205126,175
28646,28676,30,145,4.833333333333333,-29.604433333333336,116.60174761904761,176
28686,28816,130,506,3.8923076923076922,-29.591735802469135,116.60295185185186,177
28821,28876,55,142,2.581818181818182,-29.5933,116.60629166666668,178
29101,29121,20,78,3.9,-29.52628666666667,116.49632333333334,179
29231,29266,35,131,3.742857142857143,-29.475908333333333,116.46387916666666,180
29271,29291,20,59,2.95,-29.473686666666662,116.45973333333332,181
29296,29336,40,108,2.7,-29.476492592592592,116.45349444444443,182
29356,29391,35,90,2.5714285714285716,-29.47807291666667,116.45281875,183
29396,29416,20,52,2.6,-29.477476666666668,116.45216,184
29651,29706,55,208,3.7818181818181817,-29.400002777777775,116.33772916666669,185
29716,29791,75,227,3.026666666666667,-29.398713541666666,116.337496875,186
29796,29816,20,57,2.85,-29.400276666666667,116.33810333333334,187
29836,29856,20,36,1.8,-29.392443333333336,116.32576666666667,188
29906,29936,30,165,5.5,-29.374478571428572,116.29010476190477,189
30006,30026,20,45,2.25,-29.35496333333333,116.25196666666666,190
30161,30181,20,63,3.15,-29.319396666666666,116.17019,191
30391,30466,75,326,4.346666666666667,-29.248213541666665,116.070453125,192
30471,30556,85,246,2.8941176470588235,-29.249569444444447,116.07175462962965,193
30561,30581,20,49,2.45,-29.25031666666667,116.07336666666667,194
30591,30761,170,745,4.382352941176471,-29.249691428571424,116.06982523809523,195
30776,30801,25,58,2.32,-29.239372222222226,116.06704444444445,196
30831,30876,45,115,2.5555555555555554,-29.212611666666664,116.04010833333334,197
30921,30961,40,161,4.025,-29.208905555555557,116.03174074074074,198
31061,31086,25,102,4.08,-29.250375000000002,116.07713333333334,199
31241,31271,30,174,5.8,-29.333669047619047,116.09646904761904,200
31351,31386,35,87,2.4857142857142858,-29.346835416666664,116.09832708333333,201
31641,31676,35,152,4.3428571428571425,-29.46058125,116.16290208333334,202
31701,31736,35,127,3.6285714285714286,-29.462991666666664,116.16632291666667,203
31741,31766,25,79,3.16,-29.46309166666667,116.16604722222223,204
31771,31816,45,118,2.6222222222222222,-29.465751666666666,116.16707166666666,205
32121,32146,25,46,1.84,-29.597444444444438,116.29065833333333,206
32306,32341,35,200,5.714285714285714,-29.644881249999997,116.38857916666666,207
32346,32426,80,182,2.275,-29.646550980392156,116.39118137254901,208
32431,32481,50,88,1.76,-29.64555,116.3926893939394,209
32486,32516,30,108,3.6,-29.644240476190475,116.39686904761905,210
32521,32616,95,283,2.9789473684210526,-29.644644166666666,116.40113083333333,211
32656,32676,20,34,1.7,-29.668353333333336,116.40862666666666,212
32681,32706,25,34,1.36,-29.681105555555558,116.40640277777779,213
33086,33116,30,142,4.733333333333333,-29.88852380952381,116.41145714285715,214
33131,33151,20,51,2.55,-29.89375,116.41147333333333,215
33156,33191,35,121,3.4571428571428573,-29.901454166666667,116.40954166666667,216
33196,33301,105,311,2.961904761904762,-29.902456060606063,116.40875757575759,217
33326,33411,85,223,2.623529411764706,-29.903019444444446,116.40786296296295,218
33606,33631,25,76,3.04,-29.974663888888887,116.44428333333333,219
33701,33741,40,112,2.8,-30.004935185185186,116.47141666666668,220
34001,34021,20,116,5.8,-30.130996666666665,116.53759333333332,221
34081,34101,20,83,4.15,-30.15966666666667,116.55014666666666,222
34106,34141,35,58,1.6571428571428573,-30.16164583333333,116.55124791666667,223
34181,34201,20,52,2.6,-30.162439999999997,116.55521333333334,224
34206,34226,20,39,1.95,-30.162896666666665,116.5545,225
34426,34446,20,66,3.3,-30.222410000000004,116.62246999999999,226
34501,34546,45,212,4.711111111111111,-30.248543333333334,116.65824833333332,227
34566,34586,20,33,1.65,-30.25177,116.66077666666665,228
34646,34666,20,41,2.05,-30.254303333333336,116.66521,229
34671,34721,50,95,1.9,-30.25597121212121,116.66461363636363,230
34726,34751,25,44,1.76,-30.257727777777777,116.66441388888889,231
34756,34781,25,30,1.2,-30.259830555555556,116.66324722222221,232
34891,34926,35,62,1.7714285714285714,-30.309874999999998,116.68701458333334,233
35381,35406,25,40,1.6,-30.492202777777777,116.823,234
35891,35911,20,44,2.2,-30.68986,116.96676333333332,235
36021,36046,25,52,2.08,-30.74503611111111,116.99594444444445,236
36971,36996,25,46,1.84,-31.061719444444446,117.1081611111111,237
37021,37051,30,49,1.6333333333333333,-31.079828571428575,117.11798095238096,238
39461,39776,315,283,0.8984126984126984,-31.81420078125,117.12430755208334,239
39941,40006,65,42,0.6461538461538462,-31.885969047619046,117.07639047619047,240
40016,40071,55,32,0.5818181818181818,-31.90160138888889,117.06890694444444,241
40106,40191,85,65,0.7647058823529411,-31.924706481481483,117.05508796296297,242
40201,40231,30,30,1.0,-31.938940476190474,117.0457619047619,243
40236,40311,75,78,1.04,-31.95112291666667,117.037796875,244
40316,40366,50,33,0.66,-31.966381818181823,117.02920606060606,245
