t_start,t_end,duration_s,alt_gain_m,climb_rate_ms,lat,lon,cluster_id
10594,10624,30,111,3.7,-32.12289193548387,116.94798763440859,0
10625,10673,48,211,4.395833333333333,-32.11916360544218,116.93747585034015,1
10674,10724,50,232,4.64,-32.13243366013072,116.9328248366013,2
10829,10851,22,35,1.5909090909090908,-32.139056060606066,116.93533787878788,3
10876,10936,60,160,2.6666666666666665,-32.14155128205129,116.93339615384615,4
10941,10961,20,30,1.5,-32.14243333333334,116.93838666666666,5
11046,11096,50,74,1.48,-32.1505803030303,116.93462272727271,6
11211,11236,25,39,1.56,-32.15855555555555,116.9328388888889,7
11497,11524,27,61,2.259259259259259,-32.12988194444444,116.94752916666668,8
11529,11646,117,242,2.0683760683760686,-32.13595055555555,116.94592777777778,9
11651,11766,115,230,2.0,-32.146143055555555,116.94435763888889,10
11786,11811,25,40,1.6,-32.15229444444445,116.94584722222224,11
12178,12243,65,206,3.169230769230769,-32.066654761904765,116.93888095238094,12
12248,12278,30,78,2.6,-32.07094047619047,116.93873095238095,13
12707,12742,35,155,4.428571428571429,-31.93804166666667,116.91707592592593,14
12784,12809,25,93,3.72,-31.914211538461537,116.91578717948718,15
13240,13263,23,140,6.086956521739131,-31.743494444444448,116.90174513888888,16
13267,13297,30,74,2.466666666666667,-31.745390476190476,116.90212142857142,17
13302,13392,90,198,2.2,-31.74889912280702,116.90182105263155,18
13397,13453,56,141,2.517857142857143,-31.752336111111116,116.89918055555556,19
13458,13588,130,310,2.3846153846153846,-31.756858024691358,116.89886296296297,20
13623,13683,60,148,2.466666666666667,-31.76003846153846,116.8998435897436,21
13757,13777,20,128,6.4,-31.741958730158732,116.89738492063493,22
14413,14673,260,987,3.796153846153846,-31.541979874213833,116.86809182389936,23
14683,14828,145,518,3.5724137931034483,-31.550748333333335,116.85896611111112,24
14833,14869,36,110,3.0555555555555554,-31.55545625,116.85645833333334,25
14874,14914,40,63,1.575,-31.556975925925922,116.85435370370371,26
15276,15318,42,94,2.238095238095238,-31.432165555555557,116.85423999999999,27
15646,15785,139,334,2.402877697841727,-31.327451893939394,116.84890037878786,28
15873,15920,47,68,1.446808510638298,-31.3022,116.85035694444444,29
15988,16018,30,67,2.2333333333333334,-31.29032857142857,116.85465952380953,30
16137,16162,25,179,7.16,-31.264917948717944,116.85118717948718,31
16165,16252,87,289,3.32183908045977,-31.262986309523807,116.85051011904764,32
16257,16308,51,158,3.0980392156862746,-31.26806515151515,116.85273787878788,33
16318,16343,25,89,3.56,-31.27197222222222,116.85378333333334,34
16348,16383,35,83,2.3714285714285714,-31.274916666666666,116.85422083333333,35
16787,16810,23,176,7.6521739130434785,-31.111675,116.84182638888889,36
16818,16966,148,650,4.391891891891892,-31.113379292929295,116.83816565656566,37
16971,17006,35,111,3.1714285714285713,-31.117164583333334,116.83664375000001,38
17011,17106,95,251,2.642105263157895,-31.118518333333327,116.83919499999998,39
17644,17669,25,164,6.56,-30.87185769230769,116.80935,40
17802,17822,20,177,8.85,-30.81604298245614,116.80673333333331,41
17837,17857,20,52,2.6,-30.815866666666665,116.80618,42
17902,17922,20,58,2.9,-30.81999,116.80977666666668,43
18294,18654,360,1266,3.5166666666666666,-30.691500228310503,116.7809337899543,44
18659,18684,25,76,3.04,-30.703661111111114,116.7847138888889,45
19212,19499,287,879,3.062717770034843,-30.498342857142855,116.72851931216931,46
20117,20196,79,112,1.4177215189873418,-30.249210714285713,116.642875,47
20249,20519,270,1018,3.77037037037037,-30.246384848484848,116.64984545454544,48
20524,20719,195,570,2.923076923076923,-30.25368208333333,116.65464749999998,49
21698,21725,27,154,5.703703703703703,-30.508312,117.11792799999999,50
21771,21805,34,103,3.0294117647058822,-30.513842424242423,117.11965454545454,51
21835,21865,30,70,2.3333333333333335,-30.512949999999996,117.12117857142857,52
22266,22309,43,91,2.116279069767442,-30.629849999999998,117.29669999999999,53
22330,22579,249,715,2.8714859437751006,-30.636487037037032,117.305300308642,54
22703,22724,21,185,8.80952380952381,-30.683150757575753,117.36736818181816,55
22902,23138,236,627,2.656779661016949,-30.740909064327486,117.45994356725146,56
23571,23624,53,129,2.4339622641509435,-30.87748214285714,117.67418214285715,57
23940,24018,78,172,2.2051282051282053,-30.960130701754384,117.79338947368421,58
24356,24378,22,204,9.272727272727273,-31.061747826086958,117.97415434782606,59
24929,24953,24,156,6.5,-31.207348000000003,118.26034933333334,60
24972,25027,55,109,1.981818181818182,-31.210513888888887,118.25995972222223,61
25423,25453,30,108,3.6,-31.313062903225802,118.44782903225804,62
25456,25811,355,1145,3.2253521126760565,-31.31543684210526,118.45782938596491,63
25816,25841,25,81,3.24,-31.31634722222222,118.46495555555555,64
25846,25981,135,359,2.6592592592592594,-31.318161904761897,118.46648333333333,65
26055,26075,20,57,2.85,-31.33137,118.48190666666667,66
26379,26431,52,211,4.0576923076923075,-31.41728218390805,118.494758045977,67
26436,26496,60,189,3.15,-31.417346153846157,118.49565128205128,68
26501,26552,51,124,2.4313725490196076,-31.418253030303028,118.49810757575757,69
27419,27439,20,107,5.35,-31.542017460317464,118.03198492063491,70
28078,28132,54,237,4.388888888888889,-31.612584444444444,117.78946222222223,71
28137,28312,175,731,4.177142857142857,-31.617541666666668,117.78873101851852,72
28317,28367,50,157,3.14,-31.620519696969698,117.7882818181818,73
28372,28402,30,91,3.033333333333333,-31.620780952380954,117.78764047619048,74
28407,28497,90,219,2.433333333333333,-31.624028070175434,117.78719210526314,75
28537,28562,25,79,3.16,-31.629338888888892,117.78955,76
28572,28622,50,163,3.26,-31.631078787878792,117.79018333333335,77
28627,28652,25,94,3.76,-31.632099999999994,117.79089722222223,78
28657,28682,25,81,3.24,-31.633319444444442,117.79107500000002,79
29391,29491,100,156,1.56,-31.77386349206349,117.49533809523808,80
29496,29572,76,108,1.4210526315789473,-31.77726666666667,117.49495729166667,81
29597,29617,20,39,1.95,-31.78143,117.49664,82
29627,29697,70,76,1.0857142857142856,-31.784352222222218,117.49689111111113,83
30104,30131,27,132,4.888888888888889,-31.884674404761906,117.3181125,84
30132,30158,26,53,2.0384615384615383,-31.884895238095243,117.31824523809523,85
30163,30198,35,57,1.6285714285714286,-31.886277083333333,117.31967916666667,86
30208,30233,25,34,1.36,-31.888180555555554,117.32187499999999,87
30679,30709,30,38,1.2666666666666666,-31.983090476190476,117.16210238095239,88
30804,30849,45,59,1.3111111111111111,-31.988669999999995,117.164995,89
30904,30929,25,37,1.48,-31.992744444444444,117.16598611111111,90
31275,31295,20,50,2.5,-32.07072592592592,117.0339148148148,91
31310,31365,55,76,1.3818181818181818,-32.07416805555555,117.03478055555554,92
31762,31797,35,67,1.9142857142857144,-32.182945833333335,116.92691666666667,93
31822,31847,25,39,1.56,-32.18527222222223,116.93339722222224,94
31877,31907,30,59,1.9666666666666666,-32.188492857142855,116.93401666666666,95
31927,32012,85,125,1.4705882352941178,-32.19280462962962,116.9362,96
32017,32082,65,107,1.646153846153846,-32.19696785714286,116.93799404761907,97
32087,32112,25,59,2.36,-32.199841666666664,116.93913888888888,98
32117,32232,115,166,1.4434782608695653,-32.20311597222223,116.9399076388889,99
32237,32282,45,74,1.6444444444444444,-32.20683666666667,116.94293166666667,100
32287,32748,461,787,1.7071583514099784,-32.218893369175625,116.94938458781365,101
32763,32783,20,40,2.0,-32.230086666666665,116.95483333333334,102
32788,32828,40,66,1.65,-32.231538888888885,116.95718518518518,103
32833,32893,60,94,1.5666666666666667,-32.23502820512821,116.95752564102563,104
32953,33038,85,146,1.7176470588235293,-32.24245555555555,116.9604962962963,105
33259,33282,23,84,3.652173913043478,-32.319286111111104,116.90191944444445,106
33301,33407,106,188,1.7735849056603774,-32.32456231884057,116.89760942028984,107
33412,33498,86,141,1.6395348837209303,-32.329025,116.89793611111112,108
33548,33588,40,50,1.25,-32.33382592592593,116.90043703703704,109
34129,34149,20,37,1.85,-32.44757666666667,116.91221,110
